################################################################
#_________*________________\___________________________________#
#____/__________________*********___________\__________________#
#____*_____________________*___________________________________#
#__________________________*________________*__________________#
#____\___________*_________/___________________________________#
#________________________________________/**/__________________#
#________________________________________\**_________*_____\___#
#______________________________________________________________#
#__________________________________________________________*___#
#______________________________________________________________#
#_________________/_____________________*__________________/___#
#______________________________________________________________#
#______________________________________________________________#
#____________________/**_____________*_______\_________________#
#_________________*__*_______________________*_________________#
#_________________*__*_______________________\_____*_____\_____#
#_________________\**/_________________________________________#
#________________________________________________________*_____#
#______________________________________________________________#
#_______________________________________/_______*________/_____#
#_______________________________________*______________________#
#_______________/_____*____*____________/______________________#
#_______________\____**__________\_____________________________#
#________________________________\_*____________*____**________#
################################################################
